
SO ./resources/textures/example.xpm
NO ./resources/textures/example.xpm
WE ./resources/textures/example.xpm
EA ./resources/textures/example.xpm

F 255,100,0
C 100,23,33

11111111111111111111111
1S101001010101000010011
10000100010000000100011
11010000000010000000011
10001000010000001001101
10000001010100000100011
11010100101010101001101
10000000100000000000101
10000100100010000000001
11111111111111111111111
