
SO ./resources/textures/example.xpm
NO ./resources/textures/example.xpm
WE ./resources/textures/example.xpm
EA ./resources/textures/example.xpm

F 255,100,0
C 100,23,33

11111111111111111111111
10101010101010101010111
100N0000000000000000011
10101010101010101010111
10000000000000000000011
10101010101010101010111
10000000000000000000011
10101010101010101010111
10000000000000000000011
10101010101010101010111
10000000000000000000011
10000000000000000000011
10101010101010101010111
10000000000000000000011
10101010101010101010111
10000000000000000000011
10101010101010101010111
11111111111111111111111
