
SO ./resources/textures/wood.xpm
NO ./resources/textures/stone1.xpm
WE ./resources/textures/stone2.xpm
EA ./resources/textures/wall.xpm

F 105,106,107
C 135,206,235

    11111111111111111111111
11110000000000000000011
100S0000000000000000011
10000000000001000000011
10000000000000000000001
10000001000000000100011
11000000000010001001101
11000000000010001001101
10000000100000000001001
10000000000000000000001
11111111111111111111111