

SO ./resources/textures/door.xpm
NO ./resources/textures/steelwall.xpm
WE ./resources/textures/wall.xpm
EA ./resources/textures/wood.xpm

F 255,218,185
C 255,192,203

1111111111111111111111
101000100000S00000011
100100000000000000001
100000000000000000001
121112112112111111211
10001000010000010001
11000000000000000101
10000000010000000101
11111111111111111111
