

SO ./resources/textures/door.xpm
NO ./resources/textures/steelwall.xpm
WE ./resources/textures/wall.xpm
EA ./resources/textures/wood.xpm

F 255,218,185
C 255,192,203

11111111111111111111
10100S10000000000001
10010000000000000001
10000000000000000001
12111211211211111121
10001000010000010001
11000000000000000101
10000000010000000101
11111111111111111111
