

SO ./resources/textures/nazi.xpm
NO ./resources/textures/redbrick.xpm
WE ./resources/textures/hitler.xpm
EA ./resources/textures/steelwall.xpm

F 105,105,105
C 135,206,235


11111111111111111111111111111111
10000001000000100000000000000001
110100E0000000000010000000000001
12111111111111211111111111111121
10100001001000000000000000000001
11112111111121111110111111112111
10000000000000000011 10000000011
10001000100010010000101010000001
11111111111111111111111111111111
