
SO ./resources/textures/south.xpm
NO ./resources/textures/north.xpm
WE ./resources/textures/west.xpm
EA ./resources/textures/east.xpm

F 255,100,0
C 100,23,33

11111111111111111111111
10101001010101000010011
10010100101010101001101
1N000000100000000000101
10000100100010000000001
11111111111111111111111
