
SO ./resources/textures/south.xpm
NO ./resources/textures/north.xpm
WE ./resources/textures/west.xpm
EA ./resources/textures/east.xpm

F 155,118,83
C 100,23,33

11111111111111111111111
10100000000000000000011
10000000000000000000011
10000000000001000000011
1000000000E000000000001
10000001000000000100011
11000000000010001001101
10000000100000000001001
10001000000000000000001
11111111111111111111111
